11111111111111111111111111111111111111
10000000111111111111C00111011100000011
10000000100000000000000010010100000001
10000P000000CCCCC000000ECCC00101000001
11111111111100000000000000110000000001
10000000000001100000001110010000000001
11111111111111111111111111111111111111